DIA_INICIO;DIA_FINAL;SECCION_ANOMALIA;RECEPCIONADAS;ABIERTAS;CERRADAS;ABIERTAS_SIN_ACTUAR;ACTUADAS_NO_CERRADAS;ACTUADAS_Y_CERRADAS;VISADAS_NO_ACTUADAS;CERRADAS_POR_CANCELACION;TRASLADOS_INTERNOS
01/08/2015;16/08/2015;BICICLETA PUBLICA;6957;1252;5705;49;1203;5705;9;0;0
01/08/2015;16/08/2015;SE헤LIZACION ;35;27;8;24;3;8;1;0;0
01/08/2015;16/08/2015;SER;915;783;132;150;633;131;102;1;0
01/08/2015;16/08/2015;TOTAL;7907;2062;5845;223;1839;5844;112;1;0
17/08/2015;23/08/2015;BICICLETA PUBLICA;2888;1632;1256;28;1604;1256;4;0;0
17/08/2015;23/08/2015;SE헤LIZACION ;17;14;3;14;0;3;0;0;0
17/08/2015;23/08/2015;SER;564;440;124;154;286;124;56;0;0
17/08/2015;23/08/2015;TOTAL;3469;2086;1383;196;1890;1383;60;0;0
24/08/2015;30/08/2015;BICICLETA PUBLICA;3629;168;3461;107;61;3461;42;0;0
24/08/2015;30/08/2015;SE헤LIZACION ;49;39;10;39;0;10;1;0;6
24/08/2015;30/08/2015;SER;515;507;8;162;345;8;41;0;0
24/08/2015;30/08/2015;TOTAL;4193;714;3479;308;406;3479;84;0;6
31/08/2015;06/09/2015;BICICLETA PUBLICA;4211;1953;2258;185;1768;2258;31;0;1
31/08/2015;06/09/2015;SE헤LIZACION ;64;58;6;56;2;6;3;0;0
31/08/2015;06/09/2015;SER;926;921;5;299;622;5;127;0;0
31/08/2015;06/09/2015;TOTAL;5201;2932;2269;540;2392;2269;161;0;1
07/09/2015;13/09/2015;BICICLETA PUBLICA;4872;3617;1255;1306;2311;1255;35;0;1
07/09/2015;13/09/2015;SE헤LIZACION ;100;96;4;96;0;4;4;0;3
07/09/2015;13/09/2015;SER;853;849;4;170;679;4;95;0;0
07/09/2015;13/09/2015;TOTAL;5825;4562;1263;1572;2990;1263;134;0;4
14/09/2015;20/09/2015;BICICLETA PUBLICA;4525;2764;1761;1323;1441;1761;65;0;1
14/09/2015;20/09/2015;SE헤LIZACION ;83;74;9;74;0;8;1;1;2
14/09/2015;20/09/2015;SER;1005;997;8;222;775;8;98;0;1
14/09/2015;20/09/2015;TOTAL;5613;3835;1778;1619;2216;1777;164;1;4
21/09/2015;27/09/2015;BICICLETA PUBLICA;4941;4015;926;2018;1997;926;36;0;0
21/09/2015;27/09/2015;SE헤LIZACION ;77;65;12;65;0;12;1;0;3
21/09/2015;27/09/2015;SER;1003;985;18;224;761;18;95;0;1
21/09/2015;27/09/2015;TOTAL;6021;5065;956;2307;2758;956;132;0;4
28/09/2015;04/10/2015;BICICLETA PUBLICA;4201;2360;1841;963;1397;1841;16;0;0
28/09/2015;04/10/2015;SE헤LIZACION ;82;71;11;70;1;10;4;1;4
28/09/2015;04/10/2015;SER;926;852;74;194;658;74;114;0;0
28/09/2015;04/10/2015;TOTAL;5209;3283;1926;1227;2056;1925;134;1;4
05/10/2015;11/10/2015;BICICLETA PUBLICA;3907;207;3700;195;12;3698;38;2;0
05/10/2015;11/10/2015;SE헤LIZACION ;69;56;13;56;0;13;1;0;1
05/10/2015;11/10/2015;SER;995;251;744;70;181;743;59;1;3
05/10/2015;11/10/2015;TOTAL;4971;514;4457;321;193;4454;98;3;4
12/10/2015;18/10/2015;BICICLETA PUBLICA;3428;2007;1421;346;1661;1421;63;0;0
12/10/2015;18/10/2015;SE헤LIZACION ;81;81;0;81;0;0;0;0;2
12/10/2015;18/10/2015;SER;856;713;143;246;467;143;97;0;0
12/10/2015;18/10/2015;TOTAL;4365;2801;1564;673;2128;1564;160;0;2
19/10/2015;25/10/2015;BICICLETA PUBLICA;3611;1805;1806;55;1750;1806;27;0;0
19/10/2015;25/10/2015;SE헤LIZACION ;83;79;4;79;0;4;0;0;3
19/10/2015;25/10/2015;SER;1182;865;317;280;585;317;127;0;0
19/10/2015;25/10/2015;TOTAL;4876;2749;2127;414;2335;2127;154;0;3
26/10/2015;01/11/2015;BICICLETA PUBLICA;3162;1404;1758;75;1329;1758;30;0;2
26/10/2015;01/11/2015;SE헤LIZACION ;66;60;6;60;0;6;1;0;0
26/10/2015;01/11/2015;SER;965;750;215;175;575;214;85;1;0
26/10/2015;01/11/2015;TOTAL;4193;2214;1979;310;1904;1978;116;1;2
02/11/2015;08/11/2015;BICICLETA PUBLICA;3047;245;2802;55;190;2799;55;3;0
02/11/2015;08/11/2015;SE헤LIZACION ;82;79;3;79;0;3;8;0;3
02/11/2015;08/11/2015;SER;1413;1081;332;280;801;332;134;0;0
02/11/2015;08/11/2015;TOTAL;4542;1405;3137;414;991;3134;197;3;3
09/11/2015;15/11/2015;BICICLETA PUBLICA;3393;2424;969;52;2372;968;29;1;0
09/11/2015;15/11/2015;SE헤LIZACION ;58;54;4;54;0;4;1;0;3
09/11/2015;15/11/2015;SER;685;673;12;244;429;11;82;1;1
09/11/2015;15/11/2015;TOTAL;4136;3151;985;350;2801;983;112;2;4
16/11/2015;22/11/2015;BICICLETA PUBLICA;2970;2942;28;9;2933;25;7;3;0
16/11/2015;22/11/2015;SE헤LIZACION ;53;51;2;51;0;1;4;1;1
16/11/2015;22/11/2015;SER;974;967;7;238;729;5;108;2;1
16/11/2015;22/11/2015;TOTAL;3997;3960;37;298;3662;31;119;6;2
23/11/2015;29/11/2015;BICICLETA PUBLICA;2564;2433;131;81;2352;130;73;1;0
23/11/2015;29/11/2015;SE헤LIZACION ;62;54;8;54;0;8;3;0;2
23/11/2015;29/11/2015;SER;721;707;14;174;533;14;76;0;1
23/11/2015;29/11/2015;TOTAL;3347;3194;153;309;2885;152;152;1;3
30/11/2015;06/12/2015;BICICLETA PUBLICA;2065;2032;33;38;1994;32;38;1;0
30/11/2015;06/12/2015;SE헤LIZACION ;69;60;9;60;0;9;5;0;0
30/11/2015;06/12/2015;SER;297;137;160;26;111;160;22;0;0
30/11/2015;06/12/2015;TOTAL;2431;2229;202;124;2105;201;65;1;0
07/12/2015;13/12/2015;BICICLETA PUBLICA;2426;2410;16;100;2310;16;87;0;0
07/12/2015;13/12/2015;SE헤LIZACION ;50;46;4;43;3;4;2;0;2
07/12/2015;13/12/2015;SER;550;547;3;211;336;3;81;0;1
07/12/2015;13/12/2015;TOTAL;3026;3003;23;354;2649;23;170;0;3
14/12/2015;20/12/2015;BICICLETA PUBLICA;2435;942;1493;107;835;1491;93;2;0
14/12/2015;20/12/2015;SE헤LIZACION ;72;63;9;63;0;9;0;0;6
14/12/2015;20/12/2015;SER;827;695;132;311;384;129;118;3;2
14/12/2015;20/12/2015;TOTAL;3334;1700;1634;481;1219;1629;211;5;8
21/12/2015;27/12/2015;BICICLETA PUBLICA;1688;1003;685;71;932;685;66;0;0
21/12/2015;27/12/2015;SE헤LIZACION ;36;36;0;36;0;0;2;0;1
21/12/2015;27/12/2015;SER;699;696;3;398;298;3;84;0;0
21/12/2015;27/12/2015;TOTAL;2423;1735;688;505;1230;688;152;0;1
28/12/2015;03/01/2016;BICICLETA PUBLICA;1289;1279;10;65;1214;10;57;0;0
28/12/2015;03/01/2016;SE헤LIZACION ;32;32;0;32;0;0;0;0;0
28/12/2015;03/01/2016;SER;699;697;2;386;311;2;67;0;0
28/12/2015;03/01/2016;TOTAL;2020;2008;12;483;1525;12;124;0;0
04/01/2016;10/01/2016;BICICLETA PUBLICA;1283;1279;4;48;1231;4;45;0;0
04/01/2016;10/01/2016;SE헤LIZACION ;68;65;3;65;0;2;5;1;0
04/01/2016;10/01/2016;SER;749;727;22;332;395;22;118;0;0
04/01/2016;10/01/2016;TOTAL;2100;2071;29;445;1626;28;168;1;0
11/01/2016;17/01/2016;BICICLETA PUBLICA;1524;1512;12;49;1463;12;49;0;0
11/01/2016;17/01/2016;SE헤LIZACION ;84;78;6;78;0;5;3;1;2
11/01/2016;17/01/2016;SER;988;878;110;277;601;108;98;2;0
11/01/2016;17/01/2016;TOTAL;2596;2468;128;404;2064;125;150;3;2
18/01/2016;24/01/2016;BICICLETA PUBLICA;1710;1699;11;70;1629;11;67;0;0
18/01/2016;24/01/2016;SE헤LIZACION ;88;74;14;74;0;14;0;0;2
18/01/2016;24/01/2016;SER;1498;1408;90;456;952;89;113;1;1
18/01/2016;24/01/2016;TOTAL;3296;3181;115;600;2581;114;180;1;3
25/01/2016;31/01/2016;BICICLETA PUBLICA;1643;1631;12;97;1534;12;90;0;0
25/01/2016;31/01/2016;SE헤LIZACION ;99;93;6;93;0;5;7;1;2
25/01/2016;31/01/2016;SER;1182;689;493;280;409;493;53;0;0
25/01/2016;31/01/2016;TOTAL;2924;2413;511;470;1943;510;150;1;2
01/02/2016;07/02/2016;BICICLETA PUBLICA;1752;1739;13;74;1665;13;67;0;0
01/02/2016;07/02/2016;SE헤LIZACION ;106;91;15;91;0;11;3;4;1
01/02/2016;07/02/2016;SER;944;618;326;201;417;326;55;0;1
01/02/2016;07/02/2016;TOTAL;2802;2448;354;366;2082;350;125;4;2
08/02/2016;14/02/2016;BICICLETA PUBLICA;1253;1235;18;73;1162;18;73;0;0
08/02/2016;14/02/2016;SE헤LIZACION ;124;109;15;109;0;12;7;3;4
08/02/2016;14/02/2016;SER;1148;915;233;370;545;233;76;0;0
08/02/2016;14/02/2016;TOTAL;2525;2259;266;552;1707;263;156;3;4
15/02/2016;21/02/2016;BICICLETA PUBLICA;1355;1324;31;44;1280;29;44;2;1
15/02/2016;21/02/2016;SE헤LIZACION ;118;85;33;84;1;33;9;0;2
15/02/2016;21/02/2016;SER;1086;133;953;54;79;949;35;4;0
15/02/2016;21/02/2016;TOTAL;2559;1542;1017;182;1360;1011;88;6;3
22/02/2016;28/02/2016;BICICLETA PUBLICA;1299;1277;22;51;1226;22;48;0;1
22/02/2016;28/02/2016;SE헤LIZACION ;87;79;8;78;1;8;7;0;2
22/02/2016;28/02/2016;SER;963;562;401;207;355;400;51;1;1
22/02/2016;28/02/2016;TOTAL;2349;1918;431;336;1582;430;106;1;4
29/02/2016;06/03/2016;BICICLETA PUBLICA;1444;1430;14;71;1359;14;67;0;0
29/02/2016;06/03/2016;SE헤LIZACION ;113;90;23;87;3;18;1;5;5
29/02/2016;06/03/2016;SER;1154;577;577;185;392;575;44;2;2
29/02/2016;06/03/2016;TOTAL;2711;2097;614;343;1754;607;112;7;7
07/03/2016;13/03/2016;BICICLETA PUBLICA;1245;1148;97;72;1076;97;66;0;0
07/03/2016;13/03/2016;SE헤LIZACION ;97;87;10;86;1;9;6;1;2
07/03/2016;13/03/2016;SER;886;334;552;141;193;552;45;0;0
07/03/2016;13/03/2016;TOTAL;2228;1569;659;299;1270;658;117;1;2
14/03/2016;20/03/2016;BICICLETA PUBLICA;1266;1260;6;78;1182;6;72;0;0
14/03/2016;20/03/2016;SE헤LIZACION ;97;74;23;73;1;22;9;1;2
14/03/2016;20/03/2016;SER;889;454;435;211;243;435;65;0;0
14/03/2016;20/03/2016;TOTAL;2252;1788;464;362;1426;463;146;1;2
21/03/2016;27/03/2016;BICICLETA PUBLICA;695;695;0;43;652;0;34;0;0
21/03/2016;27/03/2016;SE헤LIZACION ;29;27;2;27;0;2;2;0;0
21/03/2016;27/03/2016;SER;539;464;75;184;280;75;55;0;0
21/03/2016;27/03/2016;TOTAL;1263;1186;77;254;932;77;91;0;0
28/03/2016;03/04/2016;BICICLETA PUBLICA;1178;1169;9;112;1057;9;96;0;0
28/03/2016;03/04/2016;SE헤LIZACION ;89;77;12;75;2;10;5;2;1
28/03/2016;03/04/2016;SER;1012;671;341;222;449;341;79;0;0
28/03/2016;03/04/2016;TOTAL;2279;1917;362;409;1508;360;180;2;1
04/04/2016;10/04/2016;BICICLETA PUBLICA;1228;1221;7;108;1113;7;83;0;0
04/04/2016;10/04/2016;SE헤LIZACION ;97;89;8;88;1;8;2;0;6
04/04/2016;10/04/2016;SER;924;400;524;213;187;523;66;1;1
04/04/2016;10/04/2016;TOTAL;2249;1710;539;409;1301;538;151;1;7
11/04/2016;17/04/2016;BICICLETA PUBLICA;963;954;9;70;884;9;62;0;1
11/04/2016;17/04/2016;SE헤LIZACION ;77;70;7;70;0;5;3;2;3
11/04/2016;17/04/2016;SER;876;614;262;242;372;262;71;0;0
11/04/2016;17/04/2016;TOTAL;1916;1638;278;382;1256;276;136;2;4
18/04/2016;24/04/2016;BICICLETA PUBLICA;1128;1117;11;89;1028;9;87;2;0
18/04/2016;24/04/2016;SE헤LIZACION ;111;103;8;103;0;7;1;1;4
18/04/2016;24/04/2016;SER;1093;668;425;282;386;425;83;0;1
18/04/2016;24/04/2016;TOTAL;2332;1888;444;474;1414;441;171;3;5
25/04/2016;01/05/2016;BICICLETA PUBLICA;1251;1232;19;40;1192;19;38;0;0
25/04/2016;01/05/2016;SE헤LIZACION ;112;102;10;102;0;10;6;0;5
25/04/2016;01/05/2016;SER;851;427;424;207;220;424;78;0;0
25/04/2016;01/05/2016;TOTAL;2214;1761;453;349;1412;453;122;0;5
02/05/2016;08/05/2016;BICICLETA PUBLICA;1099;1093;6;49;1044;6;44;0;0
02/05/2016;08/05/2016;SE헤LIZACION ;86;77;9;77;0;8;3;1;3
02/05/2016;08/05/2016;SER;823;808;15;305;503;15;99;0;0
02/05/2016;08/05/2016;TOTAL;2008;1978;30;431;1547;29;146;1;3
09/05/2016;15/05/2016;BICICLETA PUBLICA;964;957;7;62;895;7;55;0;0
09/05/2016;15/05/2016;SE헤LIZACION ;83;78;5;77;1;5;3;0;2
09/05/2016;15/05/2016;SER;946;577;369;196;381;369;78;0;0
09/05/2016;15/05/2016;TOTAL;1993;1612;381;335;1277;381;136;0;2
16/05/2016;22/05/2016;BICICLETA PUBLICA;1594;1579;15;138;1441;15;130;0;0
16/05/2016;22/05/2016;SE헤LIZACION ;77;71;6;71;0;6;3;0;3
16/05/2016;22/05/2016;SER;769;626;143;204;422;143;84;0;0
16/05/2016;22/05/2016;TOTAL;2440;2276;164;413;1863;164;217;0;3
23/05/2016;29/05/2016;BICICLETA PUBLICA;1482;1464;18;106;1358;18;96;0;0
23/05/2016;29/05/2016;SE헤LIZACION ;85;78;7;77;1;7;2;0;3
23/05/2016;29/05/2016;SER;980;556;424;210;346;424;57;0;0
23/05/2016;29/05/2016;TOTAL;2547;2098;449;393;1705;449;155;0;3
30/05/2016;05/06/2016;BICICLETA PUBLICA;1402;1378;24;109;1269;24;102;0;0
30/05/2016;05/06/2016;SE헤LIZACION ;84;72;12;72;0;11;2;1;4
30/05/2016;05/06/2016;SER;747;324;423;161;163;422;50;1;0
30/05/2016;05/06/2016;TOTAL;2233;1774;459;342;1432;457;154;2;4
06/06/2016;12/06/2016;BICICLETA PUBLICA;1617;1606;11;162;1444;11;154;0;0
06/06/2016;12/06/2016;SE헤LIZACION ;74;73;1;71;2;1;0;0;1
06/06/2016;12/06/2016;SER;999;986;13;252;734;13;64;0;1
06/06/2016;12/06/2016;TOTAL;2690;2665;25;485;2180;25;218;0;2
13/06/2016;19/06/2016;BICICLETA PUBLICA;1592;1574;18;152;1422;17;138;1;1
13/06/2016;19/06/2016;SE헤LIZACION ;87;83;4;83;0;4;0;0;4
13/06/2016;19/06/2016;SER;908;510;398;269;241;396;86;2;1
13/06/2016;19/06/2016;TOTAL;2587;2167;420;504;1663;417;224;3;6
20/06/2016;26/06/2016;BICICLETA PUBLICA;1812;1788;24;151;1637;24;139;0;0
20/06/2016;26/06/2016;SE헤LIZACION ;76;66;10;66;0;10;3;0;3
20/06/2016;26/06/2016;SER;890;792;98;219;573;98;72;0;0
20/06/2016;26/06/2016;TOTAL;2778;2646;132;436;2210;132;214;0;3
27/06/2016;03/07/2016;BICICLETA PUBLICA;1718;1706;12;61;1645;12;59;0;0
27/06/2016;03/07/2016;SE헤LIZACION ;48;34;14;31;3;14;2;0;4
27/06/2016;03/07/2016;SER;962;142;820;132;10;820;121;0;1
27/06/2016;03/07/2016;TOTAL;2728;1882;846;224;1658;846;182;0;5
04/07/2016;10/07/2016;BICICLETA PUBLICA;1497;1474;23;106;1368;23;95;0;0
04/07/2016;10/07/2016;SE헤LIZACION ;77;72;5;70;2;5;0;0;3
04/07/2016;10/07/2016;SER;862;239;623;165;74;623;96;0;0
04/07/2016;10/07/2016;TOTAL;2436;1785;651;341;1444;651;191;0;3
11/07/2016;17/07/2016;BICICLETA PUBLICA;1739;1725;14;155;1570;14;144;0;0
11/07/2016;17/07/2016;SE헤LIZACION ;102;94;8;94;0;8;0;0;7
11/07/2016;17/07/2016;SER;1140;775;365;264;511;365;96;0;0
11/07/2016;17/07/2016;TOTAL;2981;2594;387;513;2081;387;240;0;7
18/07/2016;24/07/2016;BICICLETA PUBLICA;1587;1574;13;163;1411;13;149;0;0
18/07/2016;24/07/2016;SE헤LIZACION ;90;87;3;87;0;3;0;0;5
18/07/2016;24/07/2016;SER;705;466;239;187;279;238;88;1;0
18/07/2016;24/07/2016;TOTAL;2382;2127;255;437;1690;254;237;1;5
25/07/2016;31/07/2016;BICICLETA PUBLICA;1326;1318;8;165;1153;8;158;0;0
25/07/2016;31/07/2016;SE헤LIZACION ;50;50;0;50;0;0;1;0;4
25/07/2016;31/07/2016;SER;585;320;265;188;132;265;104;0;0
25/07/2016;31/07/2016;TOTAL;1961;1688;273;403;1285;273;263;0;4
01/08/2016;07/08/2016;BICICLETA PUBLICA;1335;1329;6;159;1170;6;141;0;0
01/08/2016;07/08/2016;SE헤LIZACION ;54;49;5;49;0;5;1;0;2
01/08/2016;07/08/2016;SER;373;366;7;121;245;7;63;0;0
01/08/2016;07/08/2016;TOTAL;1762;1744;18;329;1415;18;205;0;2
08/08/2016;14/08/2016;BICICLETA PUBLICA;1242;1222;20;47;1175;18;46;2;3
08/08/2016;14/08/2016;SE헤LIZACION ;62;43;19;42;1;18;1;1;5
08/08/2016;14/08/2016;SER;406;14;392;14;0;392;12;0;0
08/08/2016;14/08/2016;TOTAL;1710;1279;431;103;1176;428;59;3;8
15/08/2016;21/08/2016;BICICLETA PUBLICA;1414;1399;15;120;1279;15;114;0;2
15/08/2016;21/08/2016;SE헤LIZACION ;62;53;9;51;2;9;5;0;4
15/08/2016;21/08/2016;SER;329;19;310;10;9;310;6;0;0
15/08/2016;21/08/2016;TOTAL;1805;1471;334;181;1290;334;125;0;6
22/08/2016;28/08/2016;BICICLETA PUBLICA;1753;1722;31;201;1521;31;198;0;0
22/08/2016;28/08/2016;SE헤LIZACION ;71;64;7;63;1;7;5;0;3
22/08/2016;28/08/2016;SER;467;286;181;33;253;181;29;0;0
22/08/2016;28/08/2016;TOTAL;2291;2072;219;297;1775;219;232;0;3
29/08/2016;04/09/2016;BICICLETA PUBLICA;2278;2264;14;481;1783;14;461;0;1
29/08/2016;04/09/2016;SE헤LIZACION ;104;101;3;101;0;3;1;0;5
29/08/2016;04/09/2016;SER;425;422;3;117;305;1;37;2;1
29/08/2016;04/09/2016;TOTAL;2807;2787;20;699;2088;18;499;2;7
05/09/2016;11/09/2016;BICICLETA PUBLICA;2925;2905;20;598;2307;20;530;0;0
05/09/2016;11/09/2016;SE헤LIZACION ;137;137;0;137;0;0;3;0;7
05/09/2016;11/09/2016;SER;645;642;3;144;498;3;54;0;1
05/09/2016;11/09/2016;TOTAL;3707;3684;23;879;2805;23;587;0;8
12/09/2016;18/09/2016;BICICLETA PUBLICA;2786;2753;33;530;2223;33;508;0;1
12/09/2016;18/09/2016;SE헤LIZACION ;135;129;6;129;0;6;8;0;3
12/09/2016;18/09/2016;SER;669;668;1;177;491;1;53;0;0
12/09/2016;18/09/2016;TOTAL;3590;3550;40;836;2714;40;569;0;4
19/09/2016;25/09/2016;BICICLETA PUBLICA;2772;2749;23;563;2186;23;541;0;1
19/09/2016;25/09/2016;SE헤LIZACION ;106;106;0;106;0;0;4;0;10
19/09/2016;25/09/2016;SER;636;633;3;161;472;3;45;0;0
19/09/2016;25/09/2016;TOTAL;3514;3488;26;830;2658;26;590;0;11
26/09/2016;02/10/2016;BICICLETA PUBLICA;2645;2624;21;687;1937;20;535;1;0
26/09/2016;02/10/2016;SE헤LIZACION ;108;108;0;108;0;0;2;0;8
26/09/2016;02/10/2016;SER;769;493;276;178;315;276;60;0;0
26/09/2016;02/10/2016;TOTAL;3522;3225;297;973;2252;296;597;1;8
03/10/2016;09/10/2016;BICICLETA PUBLICA;2321;2279;42;236;2043;42;213;0;0
03/10/2016;09/10/2016;SE헤LIZACION ;135;135;0;135;0;0;0;0;7
03/10/2016;09/10/2016;SER;596;232;364;112;120;364;40;0;0
03/10/2016;09/10/2016;TOTAL;3052;2646;406;483;2163;406;253;0;7
10/10/2016;16/10/2016;BICICLETA PUBLICA;1955;1920;35;233;1687;35;201;0;0
10/10/2016;16/10/2016;SE헤LIZACION ;105;105;0;105;0;0;0;0;4
10/10/2016;16/10/2016;SER;750;556;194;191;365;194;55;0;0
10/10/2016;16/10/2016;TOTAL;2810;2581;229;529;2052;229;256;0;4
17/10/2016;23/10/2016;BICICLETA PUBLICA;1535;1509;26;88;1421;25;66;1;0
17/10/2016;23/10/2016;SE헤LIZACION ;104;104;0;104;0;0;0;0;2
17/10/2016;23/10/2016;SER;965;577;388;177;400;388;67;0;0
17/10/2016;23/10/2016;TOTAL;2604;2190;414;369;1821;413;133;1;2
24/10/2016;30/10/2016;BICICLETA PUBLICA;1422;1396;26;80;1316;26;61;0;0
24/10/2016;30/10/2016;SE헤LIZACION ;90;90;0;90;0;0;0;0;1
24/10/2016;30/10/2016;SER;1087;693;394;311;382;394;113;0;0
24/10/2016;30/10/2016;TOTAL;2599;2179;420;481;1698;420;174;0;1
31/10/2016;06/11/2016;BICICLETA PUBLICA;1039;1025;14;50;975;14;40;0;0
31/10/2016;06/11/2016;SE헤LIZACION ;78;77;1;77;0;1;0;0;5
31/10/2016;06/11/2016;SER;604;536;68;238;298;67;75;1;0
31/10/2016;06/11/2016;TOTAL;1721;1638;83;365;1273;82;115;1;5
07/11/2016;13/11/2016;BICICLETA PUBLICA;1133;1122;11;93;1029;11;86;0;0
07/11/2016;13/11/2016;SE헤LIZACION ;91;88;3;88;0;3;1;0;5
07/11/2016;13/11/2016;SER;719;445;274;248;197;274;77;0;0
07/11/2016;13/11/2016;TOTAL;1943;1655;288;429;1226;288;164;0;5
14/11/2016;20/11/2016;BICICLETA PUBLICA;1178;1166;12;87;1079;12;70;0;0
14/11/2016;20/11/2016;SE헤LIZACION ;99;98;1;98;0;1;0;0;4
14/11/2016;20/11/2016;SER;807;531;276;212;319;276;65;0;0
14/11/2016;20/11/2016;TOTAL;2084;1795;289;397;1398;289;135;0;4
21/11/2016;27/11/2016;BICICLETA PUBLICA;812;795;17;79;716;17;75;0;0
21/11/2016;27/11/2016;SE헤LIZACION ;83;83;0;83;0;0;0;0;3
21/11/2016;27/11/2016;SER;1227;794;433;464;330;432;95;1;0
21/11/2016;27/11/2016;TOTAL;2122;1672;450;626;1046;449;170;1;3
28/11/2016;04/12/2016;BICICLETA PUBLICA;860;845;15;69;776;15;67;0;0
28/11/2016;04/12/2016;SE헤LIZACION ;104;103;1;103;0;1;0;0;0
28/11/2016;04/12/2016;SER;750;565;185;316;249;184;69;1;2
28/11/2016;04/12/2016;TOTAL;1714;1513;201;488;1025;200;136;1;2
05/12/2016;11/12/2016;BICICLETA PUBLICA;761;746;15;10;736;15;7;0;0
05/12/2016;11/12/2016;SE헤LIZACION ;81;81;0;81;0;0;0;0;3
05/12/2016;11/12/2016;SER;635;532;103;248;284;103;73;0;0
05/12/2016;11/12/2016;TOTAL;1477;1359;118;339;1020;118;80;0;3
12/12/2016;18/12/2016;BICICLETA PUBLICA;783;766;17;28;738;17;20;0;1
12/12/2016;18/12/2016;SE헤LIZACION ;99;98;1;98;0;1;0;0;4
12/12/2016;18/12/2016;SER;948;635;313;359;276;313;99;0;0
12/12/2016;18/12/2016;TOTAL;1830;1499;331;485;1014;331;119;0;5
19/12/2016;25/12/2016;BICICLETA PUBLICA;829;815;14;64;751;14;60;0;0
19/12/2016;25/12/2016;SE헤LIZACION ;95;94;1;94;0;1;1;0;2
19/12/2016;25/12/2016;SER;856;848;8;356;492;8;104;0;0
19/12/2016;25/12/2016;TOTAL;1780;1757;23;514;1243;23;165;0;2
26/12/2016;01/01/2017;BICICLETA PUBLICA;541;529;12;17;512;12;13;0;0
26/12/2016;01/01/2017;SE헤LIZACION ;56;56;0;56;0;0;4;0;0
26/12/2016;01/01/2017;SER;269;187;82;103;84;82;40;0;1
26/12/2016;01/01/2017;TOTAL;866;772;94;176;596;94;57;0;1
02/01/2017;08/01/2017;BICICLETA PUBLICA;614;612;2;55;557;2;54;0;1
02/01/2017;08/01/2017;SE헤LIZACION ;85;85;0;85;0;0;2;0;7
02/01/2017;08/01/2017;SER;747;648;99;289;359;99;139;0;1
02/01/2017;08/01/2017;TOTAL;1446;1345;101;429;916;101;195;0;9
09/01/2017;15/01/2017;BICICLETA PUBLICA;814;805;9;26;779;9;22;0;0
09/01/2017;15/01/2017;SE헤LIZACION ;114;114;0;114;0;0;1;0;3
09/01/2017;15/01/2017;SER;1027;567;460;320;247;460;153;0;0
09/01/2017;15/01/2017;TOTAL;1955;1486;469;460;1026;469;176;0;3
16/01/2017;22/01/2017;BICICLETA PUBLICA;643;640;3;10;630;3;10;0;0
16/01/2017;22/01/2017;SE헤LIZACION ;129;129;0;129;0;0;0;0;7
16/01/2017;22/01/2017;SER;1205;940;265;542;398;265;104;0;0
16/01/2017;22/01/2017;TOTAL;1977;1709;268;681;1028;268;114;0;7
23/01/2017;29/01/2017;BICICLETA PUBLICA;557;546;11;17;529;11;16;0;0
23/01/2017;29/01/2017;SE헤LIZACION ;110;110;0;110;0;0;0;0;3
23/01/2017;29/01/2017;SER;987;754;233;531;223;233;76;0;0
23/01/2017;29/01/2017;TOTAL;1654;1410;244;658;752;244;92;0;3
30/01/2017;05/02/2017;BICICLETA PUBLICA;564;556;8;22;534;5;17;3;0
30/01/2017;05/02/2017;SE헤LIZACION ;146;146;0;146;0;0;0;0;5
30/01/2017;05/02/2017;SER;1373;1058;315;762;296;314;75;1;1
30/01/2017;05/02/2017;TOTAL;2083;1760;323;930;830;319;92;4;6
06/02/2017;12/02/2017;BICICLETA PUBLICA;523;517;6;10;507;6;10;0;0
06/02/2017;12/02/2017;SE헤LIZACION ;111;111;0;111;0;0;1;0;5
06/02/2017;12/02/2017;SER;1060;759;301;532;227;301;107;0;0
06/02/2017;12/02/2017;TOTAL;1694;1387;307;653;734;307;118;0;5
13/02/2017;19/02/2017;BICICLETA PUBLICA;546;537;9;23;514;7;11;2;0
13/02/2017;19/02/2017;SE헤LIZACION ;130;130;0;130;0;0;0;0;3
13/02/2017;19/02/2017;SER;1115;1109;6;544;565;6;74;0;0
13/02/2017;19/02/2017;TOTAL;1791;1776;15;697;1079;13;85;2;3
20/02/2017;26/02/2017;BICICLETA PUBLICA;645;632;13;17;615;10;8;3;0
20/02/2017;26/02/2017;SE헤LIZACION ;160;160;0;160;0;0;0;0;9
20/02/2017;26/02/2017;SER;1007;918;89;449;469;87;55;2;0
20/02/2017;26/02/2017;TOTAL;1812;1710;102;626;1084;97;63;5;9
27/02/2017;05/03/2017;BICICLETA PUBLICA;615;609;6;39;570;6;32;0;0
27/02/2017;05/03/2017;SE헤LIZACION ;147;147;0;147;0;0;0;0;5
27/02/2017;05/03/2017;SER;1321;1208;113;650;558;113;66;0;0
27/02/2017;05/03/2017;TOTAL;2083;1964;119;836;1128;119;98;0;5
06/03/2017;12/03/2017;BICICLETA PUBLICA;750;729;21;49;680;18;38;3;0
06/03/2017;12/03/2017;SE헤LIZACION ;150;150;0;150;0;0;2;0;2
06/03/2017;12/03/2017;SER;937;837;100;467;370;99;69;1;0
06/03/2017;12/03/2017;TOTAL;1837;1716;121;666;1050;117;109;4;2
13/03/2017;19/03/2017;BICICLETA PUBLICA;731;723;8;17;706;8;12;0;0
13/03/2017;19/03/2017;SE헤LIZACION ;135;135;0;135;0;0;0;0;8
13/03/2017;19/03/2017;SER;955;917;38;436;481;37;48;1;0
13/03/2017;19/03/2017;TOTAL;1821;1775;46;588;1187;45;60;1;8
20/03/2017;26/03/2017;BICICLETA PUBLICA;672;666;6;30;636;6;22;0;0
20/03/2017;26/03/2017;SE헤LIZACION ;132;132;0;132;0;0;0;0;2
20/03/2017;26/03/2017;SER;810;750;60;372;378;60;44;0;0
20/03/2017;26/03/2017;TOTAL;1614;1548;66;534;1014;66;66;0;2
27/03/2017;02/04/2017;BICICLETA PUBLICA;858;846;12;42;804;12;36;0;0
27/03/2017;02/04/2017;SE헤LIZACION ;118;118;0;118;0;0;0;0;3
27/03/2017;02/04/2017;SER;981;975;6;556;419;5;61;1;0
27/03/2017;02/04/2017;TOTAL;1957;1939;18;716;1223;17;97;1;3
03/04/2017;09/04/2017;BICICLETA PUBLICA;939;928;11;50;878;9;44;2;0
03/04/2017;09/04/2017;SE헤LIZACION ;119;119;0;119;0;0;0;0;5
03/04/2017;09/04/2017;SER;795;792;3;424;368;3;38;0;0
03/04/2017;09/04/2017;TOTAL;1853;1839;14;593;1246;12;82;2;5
10/04/2017;16/04/2017;BICICLETA PUBLICA;647;633;14;40;593;14;16;0;0
10/04/2017;16/04/2017;SE헤LIZACION ;70;70;0;70;0;0;0;0;3
10/04/2017;16/04/2017;SER;432;430;2;246;184;2;31;0;0
10/04/2017;16/04/2017;TOTAL;1149;1133;16;356;777;16;47;0;3
17/04/2017;23/04/2017;BICICLETA PUBLICA;859;832;27;27;805;27;16;0;0
17/04/2017;23/04/2017;SE헤LIZACION ;122;121;1;121;0;0;0;1;8
17/04/2017;23/04/2017;SER;742;713;29;348;365;29;44;0;0
17/04/2017;23/04/2017;TOTAL;1723;1666;57;496;1170;56;60;1;8
24/04/2017;30/04/2017;BICICLETA PUBLICA;604;593;11;6;587;10;4;1;0
24/04/2017;30/04/2017;SE헤LIZACION ;129;129;0;129;0;0;0;0;3
24/04/2017;30/04/2017;SER;732;718;14;451;267;14;41;0;0
24/04/2017;30/04/2017;TOTAL;1465;1440;25;586;854;24;45;1;3
01/05/2017;07/05/2017;BICICLETA PUBLICA;514;506;8;40;466;8;19;0;0
01/05/2017;07/05/2017;SE헤LIZACION ;107;107;0;107;0;0;0;0;3
01/05/2017;07/05/2017;SER;470;470;0;181;289;0;24;0;0
01/05/2017;07/05/2017;TOTAL;1091;1083;8;328;755;8;43;0;3
08/05/2017;14/05/2017;BICICLETA PUBLICA;620;601;19;8;593;19;2;0;0
08/05/2017;14/05/2017;SE헤LIZACION ;127;127;0;127;0;0;0;0;3
08/05/2017;14/05/2017;SER;788;736;52;398;338;51;41;1;0
08/05/2017;14/05/2017;TOTAL;1535;1464;71;533;931;70;43;1;3
15/05/2017;21/05/2017;BICICLETA PUBLICA;723;29;694;4;25;691;3;3;1
15/05/2017;21/05/2017;SE헤LIZACION ;133;133;0;132;1;0;0;0;2
15/05/2017;21/05/2017;SER;916;218;698;41;177;698;34;0;0
15/05/2017;21/05/2017;TOTAL;1772;380;1392;177;203;1389;37;3;3
22/05/2017;28/05/2017;BICICLETA PUBLICA;987;978;9;82;896;8;73;1;0
22/05/2017;28/05/2017;SE헤LIZACION ;148;148;0;148;0;0;0;0;3
22/05/2017;28/05/2017;SER;933;842;91;443;399;91;54;0;0
22/05/2017;28/05/2017;TOTAL;2068;1968;100;673;1295;99;127;1;3
29/05/2017;04/06/2017;BICICLETA PUBLICA;870;853;17;66;787;17;50;0;1
29/05/2017;04/06/2017;SE헤LIZACION ;113;113;0;113;0;0;0;0;6
29/05/2017;04/06/2017;SER;768;761;7;198;563;7;108;0;0
29/05/2017;04/06/2017;TOTAL;1751;1727;24;377;1350;24;158;0;7
